11111111111111111111111111111111111111111111111111111111111111111111111
1TTTTTTTTTTTTTTTTTTTTTTTTTTTTTTTTTTTTTTTTTTTTTTTTTTTTTTTTTTTTTTTT0000E1
1TTTTTTTTTTTTTTTTTTTTTTTTTTTTTTTTTTTTTTTTTTTTTT00000000000000000000TTT1
1TTTTTTTTTTTTTTTTTTTTTTTTTTTTTTTTTTTTTTTTTTT0000TTTTTTTTTTTTTTTTTTTTTT1
1TTTTTTTTTTTTTTTTTTTTTTTTTTTTTTTTTTTTTTTTTT00TTTTTTTTTTTTTTTTTTTTTTTTT1
1TTTTTTTTTTTTTTTTTTTTTTTTTTTTTTTTTTTTTTTTT00TTTTTTTTTTTTTTTTTTTTTTTTTT1
1TTTTTTTTTTTTTTTTTTTTTTTTTTTTTTTTTTTTTTT000TTTTTTTTTTTTTTTTTTTTTTTTTTT1
1TTTTTTTTTTTTTTTTTTTTTTTTTTTTTTTTTTTTT000TTTTTTTTTTTTTTTTTTTTTTTTTTTTT1
1TTTTTTTTTTTTTTTTTTTTTTTTTTTTTTTTTTT000TTTTTTTTTTTTTTTTTTTTTTTTTTTTTTT1
1TTTTTTTTTTTTTTTTTTTTTTTTTTTTTTTT0000TTTTTTTTTTTTTTTTTTTTTTTTTTTTTTTTT1
1TTTTTTTTTTTTTTTTTTTTTTTTTTTTTT000TTTTTTTTTTTTTTTTTTTTTTTTTTTTTTTTTTTT1
1TTTTTTTTTTTTTTTTTTTTTTTTTTTT000TTTTTTTTTTTTTTTTTTTTTTTTTTTTTTTTTTTTTT1
1TTTTTTTTTTTTTTTTTTTTTTTTTT000TTTTTTTTTTTTTTTTTTTTTTTTTTTTTTTTTTTTTTTT1
1TTTTTTTTTTTTTTTTTTTTTTTT000TTTTTTTTTTTTTTTTTTTTTTTTTTTTTTTTTTTTTTTTTT1
1TTTTTTTTTTTTTTTTTTTTTT000TTTTTTTTTTTTTTTTTTTTTTTTTTTTTTTTTTTTTTTTTTTT1
1TTTTTTTTTTTTTTTTTTTT000TTTTTTTTTTTTTTTTTTTTTTTTTTTTTTTTTTTTTTTTTTTTTT1
1P00000000000000000000CTTTTTTTTTTTTTTTTTTTTTTTTTTTTTTTTTTTTTTTTTTTTTTT1
11111111111111111111111111111111111111111111111111111111111111111111111